XXXXXXXXXXXXX
XEEEEEEEEEEEX
XEEEEEEEEEEEX
XEEXXEEEEEEXX
XEEEEEEEEEEXX
XEEEEEEEEEEEX
XEEEEEEEEEEEX
XXXXXXXXXXXEX
XEEEEEEEEEEEX
XEEEEEEXEEEEX
XEEEEEEXEEEEX
XEEEEEEXEEEEX
XXXXXXXXXXXXX